2:0:0 2:0:0 2:0:0 2:0:0 2:0:0 2:0:0 2:0:0 2:0:0 2:0:0 2:0:0 2:0:0 2:0:0 2:0:0 2:0:0 2:0:0 2:0:0 2:0:0 2:0:0 2:0:0 2:0:0 2:0:0 2:0:0 2:0:0 2:0:0 2:0:0 2:0:0 2:0:0 2:0:0 2:0:0 2:0:0 2:0:0 2:0:0 2:0:0 2:0:0 2:0:0 2:0:0 2:0:0 2:0:0 2:0:0 2:0:0 2:0:0 2:0:0 2:0:0 2:0:0 2:0:0 2:0:0 2:0:0 2:0:0 2:0:0 2:0:0
2:0:0 1:0:0 1:0:0 1:0:0 1:0:0 1:0:0 1:0:0 1:0:0 1:0:0 1:0:0 1:0:0 1:0:0 1:0:0 1:0:0 1:0:0 1:0:0 1:0:0 1:0:0 1:0:0 1:0:0 1:0:0 1:0:0 1:0:0 1:0:0 1:0:0 1:0:0 1:0:0 1:0:0 1:0:0 1:0:0 1:0:0 1:0:0 1:8:0 1:0:0 1:0:0 1:0:0 1:9:0 1:9:0 1:0:0 1:0:0 1:0:0 1:0:0 1:0:0 1:0:0 1:0:0 1:0:0 1:0:0 1:0:0 1:0:0 2:0:0
2:0:0 1:0:0 1:0:0 1:0:0 2:0:0 2:0:0 2:0:0 2:0:0 2:0:0 2:0:0 2:0:0 1:0:0 1:0:0 1:0:0 1:0:0 1:0:0 1:0:0 1:0:0 1:0:0 1:0:0 1:0:0 1:0:0 1:0:0 1:0:0 1:0:0 1:0:0 1:0:0 1:0:0 1:0:0 1:0:0 1:0:0 1:0:0 1:8:0 1:0:0 1:0:0 1:9:0 1:9:0 1:9:0 1:9:0 1:0:0 1:0:0 1:0:0 1:0:0 1:0:0 1:0:0 1:0:0 1:0:0 1:0:0 1:0:0 2:0:0
2:0:0 1:0:0 1:0:0 2:0:0 2:0:0 3:0:0 3:0:0 3:0:0 3:0:0 3:0:0 2:0:0 2:0:0 2:0:0 1:0:0 1:0:0 1:0:0 1:0:0 1:0:0 1:0:0 1:0:0 1:0:0 1:0:0 1:0:0 3:0:0 3:0:0 1:0:0 1:9:0 1:9:0 1:0:0 1:0:0 1:0:0 1:0:9 1:8:9 1:0:9 1:0:0 1:9:0 1:9:0 1:9:0 1:9:0 1:0:0 1:0:0 1:0:0 1:0:0 1:0:0 1:0:0 1:0:0 1:0:0 1:0:0 1:0:0 2:0:0
2:0:0 1:0:0 1:0:0 2:0:0 3:0:0 3:0:0 3:0:0 3:0:0 3:0:0 3:0:0 3:0:0 3:0:0 2:0:0 1:0:0 1:0:0 1:0:0 1:0:0 1:0:0 1:0:0 1:0:0 1:0:0 1:0:0 1:0:0 3:0:0 3:0:0 3:0:0 1:9:0 1:9:0 1:0:0 1:0:0 1:0:9 1:0:9 1:8:9 1:0:9 1:0:0 1:0:0 1:9:0 1:9:0 1:9:0 1:0:0 1:0:0 1:0:0 1:0:0 1:0:0 1:0:0 1:0:0 1:0:0 1:0:0 1:0:0 2:0:0
2:0:0 1:0:0 1:0:0 2:0:0 3:0:0 3:0:0 3:0:0 3:0:0 3:0:0 3:0:0 3:0:0 3:0:0 2:0:0 1:0:0 1:0:0 1:0:0 1:0:0 1:0:0 1:0:0 1:0:0 1:0:0 1:0:0 1:0:0 1:0:0 3:0:0 3:0:0 3:0:0 3:0:0 3:0:0 3:0:0 1:0:9 1:0:9 1:8:9 1:0:9 1:0:9 1:0:0 1:9:0 1:9:0 1:9:0 1:9:0 1:0:0 1:0:0 1:0:0 1:0:0 1:0:0 1:0:0 1:0:0 1:0:0 1:0:0 2:0:0
2:0:0 1:0:0 1:0:0 2:0:0 3:0:0 3:0:0 3:0:0 3:0:0 3:0:0 3:0:0 3:0:0 3:0:0 2:0:0 1:0:0 1:0:0 1:0:0 1:0:0 1:0:0 1:0:0 1:0:0 1:0:0 1:0:0 1:0:0 1:0:0 1:0:0 3:0:0 3:0:0 3:0:5 3:0:5 3:0:0 3:0:9 3:0:9 1:8:9 1:0:9 1:0:0 1:0:0 1:0:0 1:9:0 1:9:0 1:9:0 1:0:0 1:0:0 1:9:0 1:9:0 1:9:0 1:9:0 1:0:0 1:0:0 1:0:0 2:0:0
2:0:0 1:0:0 1:0:0 2:0:0 3:0:0 3:0:0 3:0:0 3:0:0 3:0:0 3:0:0 3:0:0 3:0:0 2:0:0 1:0:0 1:0:0 1:9:0 1:0:0 1:0:0 1:0:0 1:0:0 1:0:0 1:0:0 1:0:0 1:0:0 1:0:0 1:0:0 3:0:0 3:0:0 3:0:0 3:0:0 3:0:0 1:0:9 1:8:9 1:0:9 1:0:0 1:0:0 1:0:0 1:0:0 1:9:0 1:9:0 1:0:0 1:0:0 1:9:0 1:9:0 1:9:0 1:9:0 1:9:0 1:0:0 1:0:0 2:0:0
2:0:0 1:0:0 1:0:0 2:0:0 3:0:0 3:0:0 3:0:0 3:0:0 3:8:0 3:0:0 3:0:0 3:0:0 2:0:0 1:0:0 1:0:0 1:9:0 1:9:0 1:9:0 1:9:0 1:9:0 1:0:0 1:0:0 1:0:0 1:0:0 1:0:0 1:0:0 1:0:0 1:0:0 1:0:0 1:0:0 3:0:0 1:0:0 1:8:9 1:0:9 1:0:0 1:0:0 1:0:0 1:0:0 1:0:0 1:0:0 1:0:0 1:0:0 1:9:0 1:9:0 1:9:0 1:9:0 1:9:0 1:9:0 1:0:0 2:0:0
2:0:0 1:0:0 1:0:0 2:0:0 2:0:0 2:0:0 2:0:0 2:0:0 3:8:0 2:0:0 2:0:0 2:0:0 2:0:0 1:0:0 1:0:0 1:9:0 1:9:0 1:9:0 1:9:0 1:9:0 1:9:0 1:0:0 1:0:0 1:0:0 1:0:0 1:0:0 1:0:0 1:0:0 1:0:0 1:0:0 1:0:0 1:0:0 1:8:0 1:0:0 1:0:0 1:0:0 1:0:0 1:0:0 1:0:0 1:0:0 1:0:0 1:0:0 1:0:0 1:9:0 1:9:0 1:9:0 1:9:0 1:9:0 1:0:0 2:0:0
2:0:0 1:0:0 1:0:0 1:0:0 1:0:0 1:0:0 1:0:0 1:0:0 1:6:0 1:7:0 1:7:0 1:6:0 1:0:0 1:0:0 1:0:0 1:0:0 1:9:0 1:9:0 1:9:0 1:9:0 1:9:0 1:0:0 1:0:0 1:0:0 1:0:0 1:0:0 1:0:0 1:0:0 1:0:0 1:0:0 1:0:0 1:0:0 1:8:0 4:0:0 4:0:0 1:0:0 1:0:0 1:0:0 1:0:0 1:0:0 1:0:0 1:0:0 1:0:0 1:0:0 1:0:0 1:9:0 1:9:0 1:9:0 1:0:0 2:0:0
2:0:0 1:0:0 1:0:0 1:9:0 1:0:0 1:0:0 1:0:0 1:0:0 1:0:0 1:0:0 1:0:0 1:8:0 1:0:0 1:0:0 1:0:0 1:0:0 1:9:0 1:9:0 1:9:0 1:0:0 1:0:0 1:0:0 1:0:0 1:0:0 1:0:0 1:0:0 1:0:0 1:0:0 1:0:0 1:0:0 1:0:0 4:0:0 4:8:0 4:0:0 4:0:0 4:0:0 4:0:0 4:0:0 4:0:0 1:0:0 1:0:0 1:0:0 1:0:0 1:0:0 1:0:0 1:0:0 1:0:0 1:0:0 1:0:0 2:0:0
2:0:0 1:0:0 1:0:0 1:9:0 1:9:0 1:0:0 1:0:0 1:0:0 1:0:0 1:0:0 1:0:0 1:8:0 1:0:0 1:0:0 1:0:0 1:0:0 1:0:0 1:0:0 1:0:0 1:0:0 1:0:0 1:0:0 1:0:0 1:0:0 1:0:0 1:0:0 1:0:0 1:0:0 1:0:0 1:0:0 1:0:0 4:0:0 4:8:0 1:5:0 1:5:0 1:5:0 1:5:0 1:5:0 4:0:0 4:0:0 4:0:0 1:0:0 1:0:0 1:0:0 1:0:0 1:0:0 1:0:0 1:0:0 1:0:0 2:0:0
2:0:0 1:0:0 1:0:0 1:9:0 1:9:0 1:9:0 1:9:0 1:0:0 1:0:0 1:0:0 1:0:0 1:8:0 1:0:0 1:0:0 1:0:0 1:0:0 1:0:0 1:0:0 1:0:0 1:0:0 1:0:0 1:0:0 1:0:0 1:0:0 1:0:0 1:0:0 1:0:0 1:0:0 1:0:0 1:0:0 1:0:0 1:0:0 4:8:0 1:5:0 1:5:0 1:5:0 1:5:0 1:5:0 1:5:0 1:5:0 4:0:0 4:0:0 1:0:0 1:0:0 1:0:0 1:0:0 1:0:0 1:0:0 1:0:0 2:0:0
2:0:0 1:0:0 1:0:0 1:9:0 1:9:0 1:9:0 1:9:0 1:9:0 1:0:0 1:0:0 1:0:0 1:8:0 1:0:0 1:0:0 1:0:0 1:0:0 1:0:0 1:0:0 1:0:0 1:0:0 1:0:0 1:0:0 1:0:0 1:0:0 1:0:0 1:0:0 1:0:0 1:0:0 1:0:0 1:0:0 1:0:0 1:0:0 4:8:0 1:5:0 1:5:0 1:5:0 1:5:0 1:5:0 1:5:0 1:5:0 4:0:0 4:0:0 1:0:0 1:0:0 1:0:0 1:0:0 1:0:0 1:0:0 1:0:0 2:0:0
2:0:0 1:0:0 1:0:0 1:0:0 1:9:0 1:9:0 1:9:0 1:9:0 1:9:0 1:0:0 1:0:0 1:8:0 1:0:0 1:0:0 1:0:0 1:0:0 2:0:0 2:0:0 2:0:0 2:0:0 2:0:0 1:0:0 1:0:0 1:0:0 1:0:0 1:0:0 1:0:0 1:0:0 1:0:0 1:0:0 1:0:0 1:0:0 4:8:0 1:5:0 1:5:0 1:5:0 1:5:0 1:5:0 1:5:0 1:5:0 4:0:0 1:0:0 1:0:0 1:0:0 1:0:0 1:0:0 1:0:0 1:0:0 1:0:0 2:0:0
2:0:0 1:0:0 1:0:0 1:0:0 1:0:0 1:9:0 1:9:0 1:9:0 1:9:0 1:9:0 1:0:0 1:8:0 1:0:0 1:0:0 1:0:0 1:0:0 2:0:0 3:0:0 3:8:0 3:0:0 2:0:0 1:0:0 1:0:0 1:0:0 1:0:0 1:0:0 1:0:0 1:0:0 1:0:0 1:0:0 1:0:0 1:0:0 4:8:0 4:0:0 4:0:0 1:5:0 1:5:0 1:5:0 4:0:0 4:0:0 4:0:0 1:0:0 1:0:0 1:0:0 1:0:0 1:0:0 1:0:0 1:0:0 1:0:0 2:0:0
2:0:0 1:0:0 1:0:0 1:0:0 1:0:0 1:0:0 1:0:0 1:0:0 1:0:0 1:0:0 1:0:0 1:8:0 1:0:0 1:0:0 1:0:0 1:0:0 2:0:0 3:0:0 3:8:0 3:0:0 2:0:0 1:0:0 1:0:0 1:0:0 1:0:0 1:0:0 1:0:0 1:0:0 1:0:0 1:0:0 1:0:0 1:0:0 1:8:0 1:0:0 4:0:0 4:0:0 4:0:0 4:0:0 4:0:0 1:0:0 1:0:0 1:0:0 1:0:0 1:0:0 1:0:0 1:0:0 1:0:0 1:0:0 1:0:0 2:0:0
2:0:0 1:0:0 1:0:0 1:0:0 1:0:0 1:0:0 1:0:0 1:0:0 1:0:0 1:0:0 1:0:0 1:8:0 1:0:0 1:0:0 1:0:0 1:0:0 2:0:0 3:0:0 3:8:0 3:0:0 2:0:0 1:0:0 1:0:0 1:0:0 1:9:0 1:9:0 1:0:0 1:0:0 1:0:0 1:0:0 1:0:0 1:0:0 1:8:0 1:0:0 1:0:0 1:0:0 1:0:0 1:0:0 1:0:0 1:0:0 1:0:0 1:0:0 1:0:0 1:0:0 1:0:0 1:9:0 1:9:0 1:0:0 1:0:0 2:0:0
2:0:0 1:0:0 1:0:0 1:0:0 1:0:0 1:9:0 1:9:0 1:0:0 1:0:0 1:0:0 1:0:0 1:8:0 1:0:0 1:0:0 1:0:0 1:0:0 2:0:0 2:0:0 3:8:0 2:0:0 2:0:0 1:0:0 1:0:0 1:0:0 1:9:0 1:9:0 1:9:0 1:0:0 1:0:0 1:0:0 1:0:0 1:0:0 1:8:0 1:0:0 1:0:0 1:0:0 1:0:0 1:0:0 1:9:0 1:0:0 1:0:0 1:0:0 1:0:0 1:0:0 1:9:0 1:9:0 1:9:0 1:0:0 1:0:0 2:0:0
2:0:0 1:0:0 1:0:0 1:0:0 1:0:0 1:9:0 1:9:0 1:9:0 1:0:0 1:0:0 1:0:0 1:6:0 1:7:0 1:7:0 1:7:0 1:7:0 1:7:0 1:7:0 1:6:0 1:0:0 1:0:0 1:0:0 1:0:0 1:9:0 1:9:0 1:9:0 1:9:0 1:9:0 1:9:0 1:0:0 1:0:0 1:0:0 1:8:0 1:0:0 1:0:0 1:0:0 1:9:0 1:9:0 1:9:0 1:0:0 1:0:0 1:0:0 1:0:0 1:9:0 1:9:0 1:9:0 1:9:0 1:9:0 1:0:0 2:0:0
2:0:0 1:0:0 1:0:0 1:0:0 1:9:0 1:9:0 1:9:0 1:9:0 1:9:0 1:0:0 1:0:0 1:0:0 1:0:0 1:0:0 1:0:0 1:0:0 1:0:0 1:0:0 1:8:0 1:0:0 1:0:0 1:0:0 1:0:0 1:9:0 1:9:0 1:9:0 1:9:0 1:9:0 1:9:0 1:9:0 1:9:0 1:0:0 1:8:0 1:9:0 1:9:0 1:9:0 1:9:0 1:9:0 1:9:0 1:9:0 1:0:0 1:0:0 1:0:0 1:9:0 1:9:0 1:9:0 1:9:0 1:9:0 1:0:0 2:0:0
2:0:0 1:0:0 1:0:0 1:0:0 1:9:0 1:9:0 1:9:0 1:9:0 1:9:0 1:0:0 1:0:0 1:0:0 1:0:0 1:0:0 1:0:0 1:0:0 1:0:0 1:0:0 1:8:0 1:0:0 1:0:0 1:0:0 1:0:0 1:0:0 1:9:0 1:9:0 1:9:0 1:9:0 1:9:0 1:9:0 1:9:0 1:9:0 1:8:0 1:9:0 1:9:0 1:9:0 1:9:0 1:9:0 1:9:0 1:9:0 1:0:0 1:0:0 1:0:0 1:0:0 1:9:0 1:9:0 1:9:0 1:9:0 1:0:0 2:0:0
2:0:0 1:0:0 1:0:0 1:0:0 1:9:0 1:9:0 1:9:0 1:9:0 1:9:0 1:9:0 1:0:0 1:0:0 1:0:0 1:0:0 1:0:0 1:0:0 1:0:0 1:0:0 1:8:0 1:0:0 1:0:0 1:0:0 1:0:0 1:9:0 1:9:0 1:9:0 1:9:0 1:9:0 1:9:0 1:9:0 1:9:0 1:9:0 1:8:0 1:0:0 1:9:0 1:9:0 1:9:0 1:9:0 1:9:0 1:0:0 1:0:0 1:0:0 1:0:0 1:0:0 1:0:0 1:9:0 1:9:0 1:0:0 1:0:0 2:0:0
2:0:0 1:0:0 1:0:0 1:0:0 1:0:0 1:0:0 1:9:0 1:9:0 1:9:0 1:9:0 1:0:0 1:0:0 1:0:0 1:0:0 1:0:0 1:0:0 1:0:0 1:0:0 1:8:0 1:0:0 1:0:0 1:0:0 1:9:0 1:9:0 1:0:0 1:0:0 1:9:0 1:9:0 1:9:0 1:9:0 1:9:0 1:0:0 1:8:0 1:0:0 1:9:0 1:9:0 1:9:0 1:9:0 1:9:0 1:0:0 1:0:0 1:0:0 1:0:0 1:0:0 1:0:0 1:0:0 1:9:0 1:0:0 1:0:0 2:0:0
2:0:0 1:0:0 1:0:0 1:0:0 1:0:0 1:0:0 1:9:0 1:9:0 1:9:0 1:9:0 1:0:0 1:0:0 1:0:0 1:0:0 1:0:0 1:0:0 1:0:0 1:0:0 1:8:0 1:0:0 1:0:0 1:0:0 1:0:0 1:0:0 1:0:0 1:0:0 1:0:0 1:0:0 1:0:0 1:0:0 1:0:0 1:0:0 1:8:0 1:0:0 1:0:0 1:9:0 1:0:0 1:0:0 1:0:0 1:0:0 1:0:0 1:0:0 1:0:0 1:0:0 1:0:0 1:0:0 1:0:0 1:0:0 1:0:0 2:0:0
2:0:0 1:0:0 1:0:0 1:0:0 1:0:0 1:0:0 1:9:0 1:9:0 1:9:0 1:9:0 1:0:0 1:0:0 1:0:0 1:0:0 1:0:0 1:0:0 1:0:0 1:0:0 1:8:0 1:0:0 1:0:0 1:0:0 1:0:0 1:0:0 1:0:0 1:0:0 1:0:0 1:0:0 1:0:0 1:0:0 1:0:0 1:0:0 1:8:0 1:0:0 1:0:0 1:0:0 1:0:0 1:0:0 1:0:0 1:0:0 1:0:0 1:0:0 1:0:0 1:0:0 1:0:0 1:0:0 1:0:0 1:0:0 1:0:0 2:0:0
2:0:0 1:0:0 1:0:0 1:0:0 1:0:0 1:0:0 1:9:0 1:9:0 1:9:0 1:9:0 1:0:0 1:0:0 1:0:0 1:0:0 1:0:0 1:0:0 1:0:0 1:0:0 1:6:0 1:7:0 1:7:0 1:7:0 1:7:0 1:7:0 1:7:0 1:7:0 1:7:0 1:7:0 1:7:0 1:7:0 1:7:0 1:7:0 1:6:0 1:7:0 1:7:0 1:7:0 1:7:0 1:7:0 1:7:0 1:7:0 1:7:0 1:6:0 1:0:0 1:0:0 1:0:0 1:0:0 1:0:0 1:0:0 1:0:0 2:0:0
2:0:0 1:0:0 1:0:0 1:0:0 1:0:0 1:0:0 1:0:0 1:9:0 1:9:0 1:9:0 1:0:0 1:0:0 1:0:0 1:0:0 1:0:0 1:0:0 1:0:0 1:0:0 1:8:0 1:0:0 1:0:0 1:0:0 1:0:0 1:0:0 1:0:0 1:0:0 1:0:0 1:0:0 1:0:0 1:0:0 1:0:0 1:0:0 1:0:0 1:0:0 1:0:0 1:0:0 1:0:0 1:0:0 1:0:0 1:0:0 1:0:0 1:8:0 1:0:0 1:0:0 1:0:0 1:9:0 1:0:0 1:0:0 1:0:0 2:0:0
2:0:0 1:0:0 1:0:0 1:0:0 1:0:0 1:0:0 1:0:0 1:0:0 1:0:0 1:0:0 1:0:0 1:0:0 1:0:0 1:0:0 1:0:0 1:0:0 1:0:0 1:0:0 1:8:0 1:0:0 1:0:0 1:0:0 1:0:0 1:0:0 1:0:0 1:0:0 1:0:0 1:0:0 1:0:0 1:0:0 1:0:0 1:0:0 1:0:0 1:0:0 1:0:0 1:0:0 1:0:0 1:0:0 1:0:0 1:0:0 1:0:0 1:8:0 1:0:0 1:0:0 1:9:0 1:9:0 1:9:0 1:9:0 1:0:0 2:0:0
2:0:0 1:0:0 1:0:0 1:0:0 1:0:0 1:0:0 1:0:0 1:0:0 1:0:0 1:0:0 1:0:0 1:0:0 1:0:0 1:0:0 1:0:0 1:0:0 1:0:0 1:0:0 1:8:0 1:0:0 1:0:0 1:0:0 1:0:0 4:0:0 4:0:0 4:0:0 4:0:0 4:0:0 1:0:0 1:0:0 1:0:0 1:0:0 1:0:0 1:0:0 1:9:0 1:9:0 1:9:0 1:0:0 1:0:0 1:0:0 1:0:0 1:8:0 1:0:0 1:0:0 1:9:0 1:9:0 1:9:0 1:9:0 1:0:0 2:0:0
2:0:0 1:0:0 1:0:0 1:0:0 1:0:0 1:0:0 1:0:0 1:0:0 1:0:0 1:0:0 1:0:0 1:0:0 1:0:0 1:0:0 1:0:0 1:0:0 1:0:0 1:0:0 1:8:0 1:0:0 1:0:0 1:0:0 4:0:0 4:0:0 4:5:0 4:5:0 4:5:0 4:0:0 4:0:0 1:0:0 1:0:0 1:0:0 1:0:0 1:0:0 1:9:0 1:9:0 1:9:0 1:9:0 1:9:0 1:0:0 1:0:0 1:8:0 1:0:0 1:0:0 1:9:0 1:9:0 1:9:0 1:9:0 1:9:0 2:0:0
2:0:0 1:0:0 1:0:0 1:0:0 1:0:0 1:0:0 1:0:0 1:0:0 1:0:0 1:0:0 1:0:0 1:0:0 1:0:0 1:0:0 1:0:0 1:0:0 1:0:0 1:0:0 1:8:0 1:0:0 1:0:0 1:0:0 4:0:0 4:5:0 4:5:0 4:5:0 1:5:0 1:5:0 4:0:0 4:0:0 4:0:0 1:0:0 1:0:0 1:0:0 1:9:0 1:9:0 1:9:0 1:9:0 1:9:0 1:0:0 1:0:0 1:8:0 1:0:0 1:0:0 1:0:0 1:9:0 1:9:0 1:9:0 1:9:0 2:0:0
2:0:0 1:0:0 1:0:0 1:0:0 1:0:0 1:0:0 1:0:0 1:0:0 1:0:0 1:0:0 3:0:0 3:0:0 3:0:0 3:0:0 1:0:0 1:0:0 1:0:0 1:0:0 1:8:0 1:0:0 1:0:0 4:0:0 4:0:0 1:5:0 4:5:0 4:5:0 1:5:0 1:5:0 1:5:0 1:5:0 4:0:0 1:0:0 1:0:0 1:0:0 1:9:0 1:9:0 1:9:0 1:9:0 1:0:0 1:0:0 1:0:0 1:8:0 1:0:0 1:0:0 1:0:0 1:0:0 1:9:0 1:9:0 1:9:0 2:0:0
2:0:0 1:0:0 1:0:0 1:0:0 1:0:0 1:0:0 1:0:0 1:0:0 1:0:0 3:0:0 3:0:0 3:0:0 3:0:0 3:0:0 1:0:0 1:0:0 1:0:0 1:0:0 1:8:0 1:0:0 1:0:0 4:0:0 1:5:0 1:5:0 1:5:0 1:5:0 1:5:0 1:5:0 1:5:0 1:5:0 4:0:0 1:0:0 1:0:0 1:0:0 1:0:0 1:9:0 1:9:0 1:0:0 1:0:0 1:0:0 1:0:0 1:8:0 1:0:0 1:0:0 1:0:0 1:0:0 1:9:0 1:9:0 1:9:0 2:0:0
2:0:0 1:0:0 1:0:0 1:0:0 1:0:0 1:0:0 1:0:0 3:0:0 3:0:0 3:0:0 3:5:0 3:0:0 3:0:0 1:0:0 1:0:0 1:0:0 1:0:0 1:0:0 1:8:0 1:0:0 4:0:0 4:0:0 1:5:0 1:5:0 1:5:0 1:5:0 1:5:0 1:5:0 1:5:0 1:5:0 4:0:0 1:0:0 1:0:0 1:0:0 1:0:0 1:0:0 1:0:0 1:0:0 1:0:0 1:0:0 1:0:0 3:8:0 1:0:0 1:0:0 1:0:0 1:0:0 1:0:0 1:0:0 1:0:0 2:0:0
2:0:0 1:0:0 1:0:0 1:0:0 1:0:0 1:0:0 3:0:0 3:0:0 3:0:0 3:5:0 3:5:0 3:0:0 1:0:0 1:0:0 1:0:0 1:0:0 1:0:0 1:0:0 1:8:0 4:0:0 4:0:0 1:5:0 1:5:0 1:5:0 1:5:0 1:5:0 1:5:0 1:5:0 1:5:0 1:5:0 4:0:0 1:0:0 1:0:0 1:0:0 1:0:0 1:0:0 1:0:0 1:0:0 1:0:0 2:0:0 2:0:0 3:8:0 2:0:0 2:0:0 1:0:0 1:0:0 1:0:0 1:0:0 1:0:0 2:0:0
2:0:0 1:0:0 1:0:0 1:0:0 1:0:0 3:0:0 3:0:0 3:5:0 3:5:0 3:5:0 3:0:0 3:7:0 1:7:0 1:7:0 1:6:0 1:7:0 1:7:0 1:7:0 1:6:0 4:7:0 1:5:0 1:5:0 1:5:0 1:5:0 1:5:0 1:5:0 1:5:0 1:5:0 1:5:0 1:5:0 4:5:0 4:0:0 1:0:0 1:0:0 1:0:0 1:0:0 1:0:0 1:0:0 2:0:0 2:0:0 3:0:0 3:8:0 3:0:0 2:0:0 2:0:0 2:0:0 1:0:0 1:0:0 1:0:0 2:0:0
2:0:0 1:0:0 1:0:0 1:0:0 3:0:0 3:0:0 3:0:0 3:0:0 3:0:0 3:0:0 3:0:0 1:0:0 1:0:0 1:0:0 1:8:0 1:0:0 1:0:0 1:0:0 1:0:0 4:0:0 4:0:0 4:0:0 1:5:0 1:5:0 1:5:0 1:5:0 1:5:0 1:5:0 1:5:0 1:5:0 1:5:0 4:0:0 4:0:0 1:0:0 1:0:0 1:0:0 2:0:0 2:0:0 2:0:0 3:0:0 3:0:0 3:8:0 3:0:0 3:0:0 3:0:0 2:0:0 2:0:0 1:0:0 1:0:0 2:0:0
2:0:0 1:0:0 1:0:0 1:0:0 3:0:0 3:0:0 3:0:0 3:0:0 3:0:0 3:0:0 3:0:0 1:0:0 1:0:0 3:0:0 3:8:0 3:0:0 1:0:0 1:0:0 1:0:0 1:0:0 1:0:0 4:0:0 4:5:0 1:5:0 1:5:0 1:5:0 1:5:0 1:5:0 1:5:0 1:5:0 1:5:0 1:5:0 4:0:0 1:0:0 1:0:0 1:0:0 2:0:0 3:0:0 3:0:0 3:0:0 3:0:0 3:8:0 3:0:0 3:0:0 3:0:0 3:0:0 2:0:0 1:0:0 1:0:0 2:0:0
2:0:0 1:0:0 1:0:0 1:0:0 1:0:0 3:0:0 3:0:0 3:0:0 3:0:0 3:0:0 3:0:0 3:0:0 3:0:0 3:0:0 3:8:0 3:0:0 3:0:0 1:0:0 1:0:0 1:0:0 1:0:0 1:0:0 4:0:0 4:5:0 1:5:0 1:5:0 1:5:0 1:5:0 1:5:0 1:5:0 1:5:0 1:5:0 4:5:0 4:0:0 1:0:0 1:0:0 2:0:0 3:0:0 3:0:0 3:0:0 3:0:0 3:0:0 3:0:0 3:0:0 3:0:0 3:0:0 2:0:0 1:0:0 1:0:0 2:0:0
2:0:0 1:0:0 1:0:0 1:0:0 1:0:0 1:0:0 1:0:0 3:0:0 3:9:0 3:9:0 3:0:0 3:0:0 3:0:0 3:0:0 3:8:0 3:0:0 3:0:0 3:0:0 3:0:0 3:9:0 1:0:0 1:0:0 4:0:0 4:5:0 1:5:0 1:5:0 1:5:0 1:5:0 1:5:0 1:5:0 1:5:0 1:5:0 1:5:0 4:0:0 1:0:0 1:0:0 2:0:0 3:0:0 3:0:0 3:0:0 3:0:0 3:0:0 3:0:0 3:0:0 3:0:0 3:0:0 2:0:0 1:0:0 1:0:0 2:0:0
2:0:0 1:0:0 1:0:0 1:0:0 1:0:0 1:0:0 1:0:0 3:0:0 3:9:0 3:9:0 3:0:0 3:0:0 3:0:0 3:0:0 3:8:0 3:0:0 3:0:0 3:0:0 3:9:0 3:9:0 3:0:0 1:0:0 4:0:0 4:0:0 4:5:0 1:5:0 1:5:0 1:5:0 1:5:0 1:5:0 4:5:0 4:5:0 4:0:0 4:0:0 1:0:0 1:0:0 2:0:0 3:0:0 3:0:0 3:0:0 3:0:0 3:0:0 3:0:0 3:0:0 3:0:0 3:0:0 2:0:0 1:0:0 1:0:0 2:0:0
2:0:0 1:0:0 1:0:0 1:0:0 1:0:0 1:0:0 1:0:0 3:0:0 3:9:0 3:9:0 3:0:0 3:0:0 3:0:0 3:0:0 3:8:0 3:0:0 3:0:0 3:0:0 3:9:0 3:9:0 3:0:0 1:0:0 4:0:0 4:0:0 4:5:0 4:5:0 1:5:0 1:5:0 4:5:0 4:5:0 4:0:0 4:0:0 4:0:0 1:0:0 1:0:0 1:0:0 2:0:0 2:0:0 3:0:0 3:0:0 3:0:0 3:0:0 3:0:0 3:0:0 3:0:0 3:0:0 2:0:0 1:0:0 1:0:0 2:0:0
2:0:0 1:0:0 1:0:0 1:0:0 1:0:0 1:0:0 1:0:0 3:0:0 3:9:0 3:9:0 3:9:0 3:0:0 3:0:0 3:0:0 3:0:0 3:0:0 3:0:0 3:9:0 3:9:0 3:9:0 3:0:0 1:0:0 1:0:0 4:0:0 4:0:0 4:0:0 4:5:0 4:5:0 4:0:0 4:0:0 4:0:0 4:0:0 1:0:0 1:0:0 1:0:0 1:0:0 1:0:0 2:0:0 2:0:0 3:0:0 3:0:0 3:0:0 3:0:0 3:0:0 2:0:0 2:0:0 2:0:0 1:0:0 1:0:0 2:0:0
2:0:0 1:0:0 1:0:0 1:0:0 1:0:0 1:0:0 1:0:0 1:0:0 3:0:0 3:9:0 3:9:0 3:9:0 3:9:0 3:0:0 3:0:0 3:9:0 3:9:0 3:9:0 3:9:0 3:0:0 3:0:0 1:0:0 1:0:0 1:0:0 1:0:0 4:0:0 4:0:0 4:0:0 4:0:0 4:0:0 4:0:0 1:0:0 1:0:0 1:0:0 1:0:0 1:0:0 1:0:0 1:0:0 2:0:0 2:0:0 2:0:0 2:0:0 2:0:0 2:0:0 2:0:0 1:0:0 1:0:0 1:0:0 1:0:0 2:0:0
2:0:0 1:0:0 1:0:0 1:0:0 1:0:0 1:0:0 1:0:0 1:0:0 3:0:0 3:0:0 3:0:0 3:9:0 3:9:0 3:9:0 3:9:0 3:9:0 3:9:0 3:9:0 3:0:0 1:0:0 1:0:0 1:0:0 1:0:0 1:0:0 1:0:0 1:0:0 1:0:0 1:0:0 1:0:0 1:0:0 1:0:0 1:0:0 1:0:0 1:0:0 1:0:0 1:0:0 1:0:0 1:0:0 1:0:0 1:0:0 1:0:0 1:0:0 1:0:0 1:0:0 1:0:0 1:0:0 1:0:0 1:0:0 1:0:0 2:0:0
2:0:0 1:0:0 1:0:0 1:0:0 1:0:0 1:0:0 1:0:0 1:0:0 1:0:0 1:0:0 1:0:0 3:0:0 3:0:0 3:0:0 3:9:0 3:0:0 3:0:0 3:0:0 1:0:0 1:0:0 1:0:0 1:0:0 1:0:0 1:0:0 1:0:0 1:0:0 1:0:0 1:0:0 1:0:0 1:0:0 1:0:0 1:0:0 1:0:0 1:0:0 1:0:0 1:0:0 1:0:0 1:0:0 1:0:0 1:0:0 1:0:0 1:0:0 1:0:0 1:0:0 1:0:0 1:0:0 1:0:0 1:0:0 1:0:0 2:0:0
2:0:0 1:0:0 1:0:0 1:0:0 1:0:0 1:0:0 1:0:0 1:0:0 1:0:0 1:0:0 1:0:0 1:0:0 1:0:0 1:0:0 3:0:0 3:0:0 1:0:0 1:0:0 1:0:0 1:0:0 1:0:0 1:0:0 1:0:0 1:0:0 1:0:0 1:0:0 1:0:0 1:0:0 1:0:0 1:0:0 1:0:0 1:0:0 1:0:0 1:0:0 1:0:0 1:0:0 1:0:0 1:0:0 1:0:0 1:0:0 1:0:0 1:0:0 1:0:0 1:0:0 1:0:0 1:0:0 1:0:0 1:0:0 1:0:0 2:0:0
2:0:0 2:0:0 2:0:0 2:0:0 2:0:0 2:0:0 2:0:0 2:0:0 2:0:0 2:0:0 2:0:0 2:0:0 2:0:0 2:0:0 2:0:0 2:0:0 2:0:0 2:0:0 2:0:0 2:0:0 2:0:0 2:0:0 2:0:0 2:0:0 2:0:0 2:0:0 2:0:0 2:0:0 2:0:0 2:0:0 2:0:0 2:0:0 2:0:0 2:0:0 2:0:0 2:0:0 2:0:0 2:0:0 2:0:0 2:0:0 2:0:0 2:0:0 2:0:0 2:0:0 2:0:0 2:0:0 2:0:0 2:0:0 2:0:0 2:0:0
